name,shortPercentage,longPercentage,shortVolume,longVolume,longPositions,shortPositions,totalPositions,avgShortPrice,avgLongPrice
EURUSD,35,65,6084.39,11538.52,42076,23543,65619,1.0829,1.102
GBPUSD,46,54,2747.37,3283.67,12695,10909,23604,1.2493,1.2821
USDJPY,73,27,4007.82,1513.91,4305,12413,16718,138.4944,142.9512
GBPJPY,82,18,2271.04,503.91,2383,6798,9181,177.2937,182.0327
USDCAD,89,11,7092.09,846.13,3763,24308,28071,1.3321,1.3486
EURAUD,80,20,2863,726.41,1119,8533,9652,1.6537,1.6696
EURJPY,87,13,4151.24,630.79,2255,13116,15371,152.9371,155.0881
AUDCAD,11,89,458.81,3596.21,16184,2382,18566,0.8768,0.8878
AUDJPY,69,31,511.19,234.33,1973,2778,4751,89.1912,94.4835
AUDNZD,88,12,2502.3,342.85,2288,10157,12445,1.0811,1.0944
AUDUSD,21,79,1031.98,3882.31,14899,3105,18004,0.6551,0.6621
CADJPY,66,34,571.56,297.02,839,4228,5067,104.6864,106.754
EURCAD,73,27,728.35,275.54,1870,3748,5618,1.4535,1.4767
EURCHF,22,78,402.58,1416.04,6902,2100,9002,0.9615,0.9811
EURCZK,63,38,0.15,0.09,3,2,5,23.7807,24.2509
EURDKK,0,0,0,0,0,0,0,0,0
EURGBP,47,53,1138.94,1291.5,5906,5730,11636,0.86,0.8687
EURHUF,92,8,5.55,0.47,23,59,82,378.0722,394.8048
EURNOK,42,58,0.87,1.22,12,26,38,10.9725,11.3964
EURNZD,95,5,1940.69,92.84,584,6202,6786,1.8008,1.8135
EURPLN,49,51,5.93,6.12,12,20,32,4.5261,4.4417
EURSEK,92,8,7.02,0.63,4,15,19,11.5177,11.8123
EURTRY,92,8,0.11,0.01,1,10,11,5.8139,25.91
GBPCAD,56,44,396.57,313.63,911,2308,3219,1.6761,1.707
GBPCHF,23,77,183.78,614.68,2573,1091,3664,1.1124,1.1361
NZDCAD,3,97,168.67,5139.49,16044,950,16994,0.8076,0.8121
NZDJPY,48,52,196.81,211.29,1544,1560,3104,83.8976,87.3303
NZDUSD,13,87,387.81,2630.21,13206,1925,15131,0.6034,0.61
USDCHF,27,73,869.43,2363.77,8259,3998,12257,0.8743,0.9014
USDCZK,96,4,0.22,0.01,1,13,14,21.7028,22.0462
USDDKK,0,0,0,0,0,0,0,0,0
USDHKD,100,0,0.02,0,0,1,1,7.7532,0
USDHUF,100,0,0.2,0,0,11,11,341.8064,0
USDMXN,15,85,13.75,76.58,128,96,224,17.1924,18.0839
USDNOK,61,39,3.25,2.11,11,34,45,10.3596,10.4633
USDPLN,73,27,0.16,0.06,3,8,11,4.0276,4.4199
USDSEK,92,8,3.47,0.32,9,30,39,10.6346,10.8539
USDSGD,82,18,10.73,2.4,31,138,169,1.3444,1.3594
USDTHB,0,100,0.17,53.2,55,5,60,34.5191,35.0614
USDTRY,20,80,0.38,1.51,4,7,11,20.8515,22.0948
USDZAR,91,9,21.49,2.15,12,81,93,17.8725,18.5074
CHFJPY,89,11,2404.6,288.84,557,7210,7767,157.2696,162.0888
AUDCHF,3,97,126.38,3695.47,8988,646,9634,0.58,0.5924
GBPNZD,91,9,1503.62,155.04,742,5904,6646,2.0792,2.0364
NZDCHF,2,98,34.21,1870.8,5867,270,6137,0.5292,0.5421
XAGUSD,25,75,148.74,449.65,1813,568,2381,22.1167,23.7262
XAUUSD,27,73,3436.09,9097.41,39980,16845,56825,1881.856,1940.7506
CADCHF,5,95,205.88,3922.68,21989,1155,23144,0.6543,0.6793
GBPAUD,87,13,857.68,132.18,746,4115,4861,1.9032,1.9391
SPA35,0,100,0,0.18,1,0,1,0,6818.78
SGDJPY,97,3,3.75,0.13,9,138,147,102.4034,106.9893
SUGAR,0,100,0,26.4,16,0,16,0,12.1781
GBPNOK,0,100,0,1.01,2,0,2,0,13.1753
US30,36,64,3,5.31,2,1,3,28262,28250.5
EURZAR,99,1,7.67,0.06,5,386,391,18.9641,19.6664
AUDSGD,29,71,1.16,2.9,83,98,181,0.9725,0.905
GBPZAR,0,0,0,0,0,0,0,0,0
GBPSEK,1,99,0.01,1.02,3,1,4,13.4216,13.7679
CHFSGD,96,4,4.04,0.16,8,104,112,1.5136,1.5423
EURSGD,87,13,6.18,0.89,41,104,145,1.4763,1.4971
GBPSGD,65,35,1.52,0.81,33,43,76,1.6724,1.7274
AUDDKK,0,0,0,0,0,0,0,0,0
EURHKD,38,63,1.08,1.8,45,4,49,9.6469,9.5579
GBPDKK,0,0,0,0,0,0,0,0,0
COPPER,0,100,0,0.03,3,0,3,0,2.9333
COFFEE,80,20,4,1,1,3,4,105.71,116.09
EURO50,0,0,0,0,0,0,0,0,0
TRYJPY,0,100,0.02,5.83,10,1,11,47.486,49.5919
US500,100,0,1.1,0,0,2,2,3086,0
GBPPLN,0,0,0,0,0,0,0,0,0
WHEAT,0,100,0,0.01,1,0,1,0,509
COCOA,100,0,0.05,0,0,1,1,2474,0
UK100,100,0,1.36,0,0,6,6,5908.5,0
XAUGBP,62,38,4.8,2.96,21,23,44,1509.8565,1519.241
COTTON,0,100,0,0.03,3,0,3,0,63.6233
NOKJPY,64,36,1.82,1.04,8,20,28,13.646,14.0373
SP500,0,0,0,0,0,0,0,0,0
ZARJPY,0,100,0,16.66,70,0,70,0,8.0184
HKDJPY,0,0,0,0,0,0,0,0,0
CHFNOK,50,50,0.02,0.02,1,1,2,6.8991,6.9784
GBPTRY,100,0,0.01,0,0,1,1,34.4813,0
USDRUB,100,0,0.01,0,0,1,1,89.577,0
SEKJPY,55,45,1.76,1.44,9,11,20,13.2575,13.554
MSFT,0,0,0,0,0,0,0,0,0
JNJ,0,0,0,0,0,0,0,0,0
EURMXN,58,42,1.64,1.21,16,59,75,18.6279,22.638
XAUAUD,97,3,2.79,0.1,6,46,52,2922.9085,2943.38
XAUEUR,25,75,7.01,20.8,175,104,279,1745.9246,1766.6042
WS30,0,0,0,0,0,0,0,0,0
NAS100,2,98,0.01,0.61,7,1,8,11425,11793.2857
SGDHKD,0,0,0,0,0,0,0,0,0
US2000,100,0,2,0,0,2,2,1558.68,0
FRA40,94,6,4,0.26,1,4,5,4755.5,4876
GER30,0,100,0,0.1,1,0,1,0,12563
AUDSEK,0,0,0,0,0,0,0,0,0
XAUJPY,84,16,3.97,0.77,14,36,50,276757.4444,277253.9286
XAUCHF,20,80,0.17,0.67,35,6,41,1679.2533,1687.8271
CHFSEK,100,0,0.1,0,0,10,10,7.579,0
AUS200,50,50,1,1,1,1,2,5375,4875
GBPMXN,98,2,0.62,0.01,1,4,5,21.6149,22.1303
JPN225,0,100,0,1,1,0,1,0,23368
XAGAUD,0,100,0,0.01,1,0,1,0,36.138
NOKSEK,36,64,6.42,11.52,40,24,64,1.0277,1.0472
USDX,0,100,0,0.3,1,0,1,0,94.324
XAGEUR,7,93,0.05,0.64,19,1,20,20.663,21.8875
EBAY,0,0,0,0,0,0,0,0,0
VIX,0,100,0,0.2,2,0,2,0,29.255
CHFHKD,0,0,0,0,0,0,0,0,0
YHOO,0,100,0,8,1,0,1,0,38.05
XPTUSD,0,100,0,2.1,12,0,12,0,1010.6283
GBPHKD,0,0,0,0,0,0,0,0,0
XPDUSD,0,100,0,0.17,11,0,11,0,1626.5009
CADHKD,0,0,0,0,0,0,0,0,0
USDCNH,83,17,7.33,1.53,32,40,72,7.0671,7.2112
AUDHKD,0,0,0,0,0,0,0,0,0
NZDHKD,0,0,0,0,0,0,0,0,0
AAPL,0,0,0,0,0,0,0,0,0
PFE,0,100,0,0.5,1,0,1,0,29.7
FB,0,100,0,0.5,1,0,1,0,119.44
IT40,100,0,4,0,0,1,1,18825.3,0
GS,0,0,0,0,0,0,0,0,0
NKE,0,0,0,0,0,0,0,0,0
BA,0,0,0,0,0,0,0,0,0
CVX,0,0,0,0,0,0,0,0,0
GOOG,0,100,0,1,1,0,1,0,679.28
XTIUSD,0,100,0,3,3,0,3,0,68.8433
BTCUSD,25,75,93.59,280.57,3112,504,3616,28763.7758,41740.1469
XBRUSD,0,100,0,0.03,3,0,3,0,72.5633
US30.D,100,0,1,0,0,1,1,27727,0
BTCEUR,0,100,0,0.08,7,0,7,0,54368.0629
LTCBTC,0,100,0,2,2,0,2,0,0
LTCUSD,1,99,22.63,1702.99,1631,27,1658,92.4033,204.4376
TWTR,0,100,0,1,1,0,1,0,16.61
HK50,100,0,0.1,0,0,1,1,23711,0
GOPRO,0,100,0,0.01,1,0,1,0,10.91
XNGUSD,100,0,0.02,0,0,1,1,2.77,0
APPL,0,0,0,0,0,0,0,0,0
DXU5,0,0,0,0,0,0,0,0,0
DXZ5,0,100,0,2,2,0,2,0,99.35
OGZD,0,0,0,0,0,0,0,0,0
CN50,33,67,0.2,0.4,4,1,5,15071.4,15240.15
BTCJPY,100,0,0.79,0,0,8,8,4170807,0
ETHUSD,17,83,121.71,598.46,1994,330,2324,1608.9446,2938.1019
DSHUSD,67,33,0.02,0.01,1,2,3,31.05,32.08
DASH,100,0,2.9,0,0,7,7,129.0229,0
BTCGBP,50,50,0.01,0.01,1,1,2,22665.11,22879.65
XRPUSD,9,91,15.85,152.46,244,74,318,0.4846,0.5788
BCHUSD,2,98,2.32,142.13,112,11,123,189.7982,655.7263
ZECUSD,0,100,0,1,3,0,3,0,35.8633
XMRUSD,14,86,0.01,0.06,4,1,5,157.93,161.4225
NEOUSD,0,100,0,11.5,10,0,10,0,9.803
OMGUSD,0,100,0,0.01,1,0,1,0,0.76
RIPPLE,100,0,0.1,0,0,1,1,0.27,0
EOSUSD,0,100,0,7.98,20,0,20,0,1.77
XLMUSD,77,23,24.06,7.37,16,5,21,0.14,0.185
TRXUSD,0,100,0,0.02,1,0,1,0,0.08
ADAUSD,14,86,6.05,37.23,71,13,84,0.2862,0.7601
XTZUSD,100,0,0.1,0,0,1,1,1,0
BATUSD,0,100,0,0.75,6,0,6,0,0
FTMUSD,0,100,0,0.01,1,0,1,0,0
FETUSD,0,100,0,0.05,5,0,5,0,0
SCI25,0,100,0,0.2,2,0,2,0,303.25
CNI30,100,0,0.2,0,0,2,2,1212.3,0
BIO30,0,100,0,0.1,1,0,1,0,1346.6
LAT30,0,100,0,0.1,1,0,1,0,563.1
JPYX,100,0,1,0,0,1,1,997.5,0
MKRUSD,0,100,0,0.01,1,0,1,0,1289
DOTUSD,17,83,2.77,13.57,29,4,33,8.7638,22.7246
UNIUSD,3,97,0.43,15,3,1,4,6,5.3333
ICPUSD,100,0,0.3,0,0,1,1,4,0
SOLUSD,27,73,21.12,57.05,83,13,96,21.2308,69.6506
SNXUSD,0,100,0,0.1,1,0,1,0,3
FILUSD,0,100,0,0.01,1,0,1,0,5
AXSUSD,0,100,0,0.02,1,0,1,0,6
ZILUSD,100,0,0.34,0,0,1,1,0,0
GRTUSD,0,100,0,0.01,1,0,1,0,0
